{
	"playerStart": {
		"x": 8.5,
		"y": 8.5,
		"angle": 0
	},
	"tile": {
		"tileLookUp": {
			"wall": [
				"empty",
				"bricks",
				"test",
				"arrow",
				"solid"
			],
			"floor": [
				"void",
				"bricks",
				"test",
				"arrow",
				"solid"
			],
			"ceiling": [
				"sky",
				"bricks",
				"test",
				"arrow",
				"solid"
			]
		},
		"tileData": {
			"wall": [
				[ 1, 1, 1, 1, 1, 1, 1, 1, 1, 1, 1, 1, 1, 2, 2, 2 ],
				[ 1, 0, 0, 0, 0, 0, 0, 0, 0, 1, 0, 0, 0, 2, 0, 2 ],
				[ 1, 0, 1, 1, 0, 0, 0, 0, 0, 0, 1, 0, 0, 2, 2, 2 ],
				[ 1, 0, 1, 1, 1, 0, 0, 0, 0, 0, 0, 1, 4, 4, 4, 1 ],
				[ 1, 0, 1, 1, 1, 1, 0, 0, 0, 0, 0, 0, 4, 0, 4, 1 ],
				[ 1, 0, 1, 1, 1, 1, 1, 0, 0, 0, 0, 0, 4, 0, 4, 1 ],
				[ 1, 0, 1, 1, 1, 1, 0, 0, 0, 0, 1, 1, 4, 0, 4, 1 ],
				[ 1, 0, 1, 1, 1, 0, 0, 0, 0, 0, 1, 1, 4, 0, 4, 1 ],
				[ 1, 0, 1, 1, 0, 0, 0, 0, 0, 0, 0, 0, 4, 0, 4, 1 ],
				[ 1, 0, 0, 0, 0, 0, 0, 0, 0, 0, 0, 0, 4, 0, 4, 1 ],
				[ 1, 0, 0, 0, 0, 0, 0, 0, 0, 0, 0, 0, 4, 0, 4, 1 ],
				[ 1, 0, 0, 0, 0, 0, 0, 0, 3, 0, 0, 0, 0, 0, 3, 1 ],
				[ 1, 0, 0, 0, 0, 0, 0, 0, 0, 0, 0, 0, 3, 3, 3, 1 ],
				[ 1, 0, 0, 1, 0, 0, 0, 0, 0, 0, 0, 0, 0, 0, 0, 1 ],
				[ 1, 0, 0, 0, 0, 0, 0, 0, 1, 1, 1, 1, 1, 1, 1, 1 ],
				[ 2, 2, 1, 2, 1, 1, 2, 2, 2, 2, 2, 2, 2, 2, 2, 2 ]
			],
			"floor": [
				[ 1, 1, 1, 1, 1, 1, 1, 1, 1, 1, 1, 1, 1, 1, 1, 1 ],
				[ 1, 2, 2, 2, 2, 2, 1, 1, 1, 1, 1, 1, 1, 1, 2, 1 ],
				[ 1, 2, 1, 1, 1, 1, 1, 1, 1, 1, 1, 1, 1, 1, 1, 1 ],
				[ 1, 2, 1, 1, 1, 1, 1, 1, 1, 1, 1, 1, 1, 1, 1, 1 ],
				[ 1, 2, 1, 1, 1, 1, 1, 1, 1, 1, 1, 1, 1, 4, 1, 1 ],
				[ 1, 2, 1, 1, 1, 0, 0, 0, 0, 0, 0, 1, 1, 4, 1, 1 ],
				[ 1, 1, 1, 1, 1, 0, 3, 3, 3, 3, 0, 1, 1, 4, 1, 1 ],
				[ 1, 1, 1, 1, 1, 0, 3, 3, 3, 3, 0, 1, 1, 4, 1, 1 ],
				[ 1, 1, 1, 1, 1, 0, 3, 3, 3, 3, 0, 1, 1, 4, 1, 1 ],
				[ 1, 1, 1, 1, 1, 0, 3, 3, 3, 3, 0, 1, 1, 4, 1, 1 ],
				[ 1, 1, 1, 1, 1, 0, 0, 0, 0, 0, 0, 1, 1, 4, 1, 1 ],
				[ 1, 1, 1, 1, 1, 1, 1, 1, 1, 1, 1, 1, 1, 4, 1, 1 ],
				[ 1, 1, 1, 1, 1, 1, 1, 1, 1, 1, 1, 1, 1, 1, 1, 1 ],
				[ 1, 1, 1, 1, 1, 1, 1, 1, 1, 1, 1, 1, 1, 1, 1, 1 ],
				[ 1, 1, 1, 1, 1, 1, 1, 1, 1, 1, 1, 1, 1, 1, 1, 1 ],
				[ 1, 1, 1, 1, 1, 1, 1, 1, 1, 1, 1, 1, 1, 1, 1, 1 ]
			],
			"ceiling": [
				[ 0, 0, 0, 0, 0, 0, 0, 0, 0, 0, 0, 0, 0, 0, 0, 0 ],
				[ 0, 2, 2, 2, 2, 2, 2, 2, 2, 2, 2, 2, 2, 2, 2, 0 ],
				[ 0, 2, 0, 0, 0, 0, 0, 0, 0, 0, 0, 0, 0, 0, 2, 0 ],
				[ 0, 2, 0, 0, 0, 0, 0, 0, 0, 0, 0, 0, 0, 0, 2, 0 ],
				[ 0, 2, 0, 0, 0, 0, 0, 0, 0, 0, 0, 0, 0, 4, 2, 0 ],
				[ 0, 2, 0, 0, 0, 0, 0, 0, 0, 0, 0, 0, 0, 4, 2, 0 ],
				[ 0, 2, 0, 0, 0, 0, 3, 3, 3, 3, 0, 0, 0, 4, 2, 0 ],
				[ 0, 2, 0, 0, 0, 0, 3, 3, 3, 3, 0, 0, 0, 4, 2, 0 ],
				[ 0, 2, 0, 0, 0, 0, 3, 3, 3, 3, 0, 0, 0, 4, 2, 0 ],
				[ 0, 2, 0, 0, 0, 0, 3, 3, 3, 3, 0, 0, 0, 4, 2, 0 ],
				[ 0, 2, 0, 0, 0, 0, 0, 0, 0, 0, 0, 0, 0, 4, 2, 0 ],
				[ 0, 2, 0, 0, 0, 0, 0, 0, 0, 0, 0, 0, 0, 4, 2, 0 ],
				[ 0, 2, 0, 0, 0, 0, 0, 0, 0, 0, 0, 0, 0, 0, 2, 0 ],
				[ 0, 2, 0, 0, 0, 0, 0, 0, 0, 0, 0, 0, 0, 0, 2, 0 ],
				[ 0, 2, 2, 2, 2, 2, 2, 2, 2, 2, 2, 2, 2, 2, 2, 0 ],
				[ 0, 0, 0, 0, 0, 0, 0, 0, 0, 0, 0, 0, 0, 0, 0, 0 ]
			]
		}
	},
	"lighting": {
		"fog": {
			"color": 0,
			"saturation": 0,
			"brightness": 0,
			"distance": 7
		},
		"sector": {
			"color": [
				[7, 7, 7, 7, 7, 7, 7, 7, 7, 7, 7, 7, 7, 7, 7, 7],
				[7, 7, 7, 7, 7, 7, 7, 7, 7, 7, 7, 7, 7, 7, 7, 7],
				[7, 7, 7, 7, 7, 7, 7, 7, 7, 7, 7, 7, 7, 7, 7, 7],
				[7, 7, 7, 7, 7, 7, 7, 7, 7, 7, 7, 7, 7, 7, 7, 7],
				[7, 7, 7, 7, 7, 7, 7, 7, 7, 7, 7, 7, 7, 7, 7, 7],
				[7, 7, 7, 7, 7, 7, 7, 7, 7, 7, 7, 7, 7, 7, 7, 7],
				[7, 7, 7, 7, 7, 7, 7, 7, 7, 7, 7, 7, 7, 7, 7, 7],
				[7, 7, 7, 7, 7, 7, 7, 7, 7, 7, 7, 7, 7, 7, 7, 7],
				[7, 7, 7, 7, 7, 7, 7, 7, 7, 7, 7, 7, 7, 7, 7, 7],
				[7, 7, 7, 7, 7, 7, 7, 7, 7, 7, 7, 7, 7, 7, 7, 7],
				[7, 7, 7, 7, 7, 7, 7, 7, 7, 7, 7, 7, 7, 7, 7, 7],
				[7, 7, 7, 7, 7, 7, 7, 7, 7, 7, 7, 7, 7, 7, 7, 7],
				[7, 7, 7, 7, 7, 7, 7, 7, 7, 7, 7, 7, 7, 7, 7, 7],
				[7, 7, 7, 7, 7, 7, 7, 7, 7, 7, 7, 7, 7, 7, 7, 7],
				[7, 7, 7, 7, 7, 7, 7, 7, 7, 7, 7, 7, 7, 7, 7, 7],
				[7, 7, 7, 7, 7, 7, 7, 7, 7, 7, 7, 7, 7, 7, 7, 7]
			],
			"saturation": [
				[0, 0, 0, 0, 0, 0, 0, 0, 0, 0, 0, 0, 0, 0, 0, 0],
				[0, 0, 0, 0, 0, 0, 0, 0, 0, 0, 0, 0, 0, 0, 0, 0],
				[0, 0, 0, 0, 0, 0, 0, 0, 0, 0, 0, 0, 0, 0, 0, 0],
				[0, 0, 0, 0, 0, 0, 0, 0, 0, 0, 0, 0, 0, 0, 0, 0],
				[0, 0, 0, 0, 0, 0, 0, 0, 0, 0, 0, 0, 0, 0, 0, 0],
				[0, 0, 0, 0, 0, 0, 0, 0, 0, 0, 0, 0, 0, 0, 0, 0],
				[0, 0, 0, 0, 0, 0, 0, 0, 0, 0, 0, 0, 0, 0, 0, 0],
				[0, 0, 0, 0, 0, 0, 0, 0, 0, 0, 0, 0, 0, 0, 0, 0],
				[0, 0, 0, 0, 0, 0, 0, 0, 0, 0, 0, 0, 0, 0, 0, 0],
				[0, 0, 0, 0, 0, 0, 0, 0, 0, 0, 0, 0, 0, 0, 0, 0],
				[0, 0, 0, 0, 0, 0, 0, 0, 0, 0, 0, 0, 0, 0, 0, 0],
				[0, 0, 0, 0, 0, 0, 0, 0, 0, 0, 0, 0, 0, 0, 0, 0],
				[0, 0, 0, 0, 0, 0, 0, 0, 0, 0, 0, 0, 0, 0, 0, 0],
				[0, 0, 0, 0, 0, 0, 0, 0, 0, 0, 0, 0, 0, 0, 0, 0],
				[0, 0, 0, 0, 0, 0, 0, 0, 0, 0, 0, 0, 0, 0, 0, 0],
				[0, 0, 0, 0, 0, 0, 0, 0, 0, 0, 0, 0, 0, 0, 0, 0]
			],
			"brightness": [
				[7, 7, 7, 7, 7, 7, 7, 7, 7, 7, 7, 7, 7, 7, 7, 7],
				[7, 7, 7, 7, 7, 7, 7, 7, 7, 7, 7, 7, 7, 7, 0, 7],
				[7, 7, 7, 7, 7, 7, 7, 7, 7, 7, 7, 7, 7, 7, 7, 7],
				[7, 7, 7, 7, 7, 7, 7, 7, 7, 7, 7, 7, 7, 7, 7, 7],
				[7, 7, 7, 7, 7, 7, 7, 7, 7, 7, 7, 7, 7, 0, 7, 7],
				[7, 7, 7, 7, 7, 7, 7, 7, 7, 6, 5, 5, 6, 1, 7, 7],
				[7, 7, 7, 7, 7, 7, 6, 5, 5, 4, 7, 7, 5, 2, 7, 7],
				[7, 7, 7, 7, 7, 7, 5, 4, 4, 5, 7, 7, 5, 3, 7, 7],
				[7, 7, 7, 7, 7, 7, 5, 4, 4, 6, 5, 5, 6, 4, 7, 7],
				[7, 7, 7, 7, 7, 7, 6, 5, 5, 6, 7, 7, 7, 5, 7, 7],
				[7, 7, 7, 7, 7, 7, 7, 7, 7, 7, 7, 7, 7, 6, 7, 7],
				[7, 7, 7, 7, 7, 7, 7, 7, 7, 7, 7, 7, 7, 7, 7, 7],
				[7, 7, 7, 7, 7, 7, 7, 7, 7, 7, 7, 7, 7, 7, 7, 7],
				[7, 7, 7, 7, 7, 7, 7, 7, 7, 7, 7, 7, 7, 7, 7, 7],
				[7, 6, 5, 4, 3, 2, 1, 0, 7, 7, 7, 7, 7, 7, 7, 7],
				[7, 7, 7, 7, 7, 7, 7, 7, 7, 7, 7, 7, 7, 7, 7, 7]
			]
		}
	}
}